17 50 4

0 0 , 0 0 , 0 0 , 0 0 , 0 0 , 0 0 , 0 0 , 0 0 , 0 0 , 0 0 , 0 0 , 0 0 , 0 0 , 0 0 , 0 0 , 0 0 , 0 0 , 0 0 , 0 0 , 1 0 , 1 0 , 1 0 , 1 0 , 1 0 , 1 0 , 1 0 , 1 0 , 1 0 , 1 0 , 1 0 , 1 0 , 1 0 , 1 0 , 1 0 , 1 0 , 1 0 , 1 0 , 1 0 , 1 0 , 1 0 , 1 0 , 1 0 , 1 0 , 1 0 , 1 0 , 1 0 , 1 0 , 1 0 , 1 0 , 1 0 ;
0 0 , 0 0 , 0 0 , 0 0 , 0 0 , 0 0 , 0 0 , 0 0 , 0 0 , 0 0 , 0 0 , 0 0 , 0 0 , 0 0 , 0 0 , 0 0 , 0 0 , 0 0 , 0 0 , 0 0 , 1 0 , 1 0 , 1 0 , 1 0 , 1 0 , 1 0 , 1 0 , 5 0 , 1 0 , 1 0 , 1 0 , 1 0 , 1 0 , 2 0 , 2 0 , 2 0 , 2 0 , 2 0 , 2 0 , 2 0 , 2 0 , 2 0 , 1 0 , 1 0 , 1 0 , 5 0 , 1 0 , 1 0 , 1 0 , 1 0 ;
0 0 , 0 0 , 0 0 , 0 0 , 0 0 , 0 0 , 0 0 , 0 0 , 0 0 , 1 0 , 1 0 , 1 0 , 1 0 , 0 0 , 0 0 , 0 0 , 0 0 , 0 0 , 0 0 , 1 0 , 1 0 , 1 0 , 1 0 , 1 0 , 1 0 , 1 0 , 1 0 , 1 0 , 1 0 , 1 0 , 1 0 , 1 0 , 1 0 , 2 0 , 2 0 , 2 0 , 2 0 , 6 0 , 2 0 , 2 0 , 2 0 , 2 0 , 1 0 , 1 0 , 1 0 , 1 0 , 1 0 , 1 0 , 1 0 , 1 0 ;
0 0 , 0 0 , 0 0 , 0 0 , 0 0 , 0 0 , 0 0 , 1 0 , 1 0 , 1 0 , 5 0 , 1 0 , 1 0 , 1 0 , 0 0 , 0 0 , 0 0 , 0 0 , 0 0 , 1 0 , 1 0 , 1 0 , 1 0 , 1 0 , 1 0 , 1 0 , 1 0 , 1 0 , 1 0 , 1 0 , 1 0 , 1 0 , 1 0 , 1 0 , 1 0 , 1 0 , 2 0 , 2 0 , 2 0 , 2 0 , 2 0 , 2 0 , 2 0 , 1 0 , 1 0 , 1 0 , 1 0 , 1 0 , 1 0 , 1 0 ;
0 0 , 0 0 , 0 0 , 1 0 , 1 0 , 1 0 , 1 0 , 1 0 , 1 0 , 1 0 , 1 0 , 1 0 , 1 0 , 7 0 , 1 0 , 1 0 , 1 0 , 1 0 , 0 0 , 0 0 , 1 0 , 1 0 , 1 0 , 1 0 , 1 0 , 1 0 , 3 0 , 3 0 , 3 0 , 3 0 , 3 0 , 3 0 , 3 0 , 1 0 , 1 0 , 1 0 , 1 0 , 1 0 , 1 0 , 1 0 , 2 0 , 2 0 , 2 0 , 1 0 , 1 0 , 1 0 , 1 0 , 1 0 , 1 0 , 1 0 ;
0 0 , 0 0 , 1 0 , 1 0 , 1 0 , 1 0 , 1 0 , 1 0 , 1 0 , 1 0 , 2 0 , 2 0 , 2 0 , 2 0 , 1 0 , 1 0 , 1 0 , 1 0 , 1 0 , 1 0 , 1 0 , 1 0 , 1 0 , 1 0 , 1 0 , 3 0 , 3 0 , 3 0 , 3 0 , 3 0 , 3 0 , 3 0 , 1 0 , 1 0 , 1 0 , 1 0 , 1 0 , 1 0 , 1 0 , 1 0 , 1 0 , 2 0 , 2 0 , 2 0 , 1 0 , 1 0 , 1 0 , 1 0 , 1 0 , 1 0 ;
0 0 , 1 0 , 1 0 , 1 0 , 5 0 , 1 0 , 1 0 , 1 0 , 1 0 , 1 0 , 2 0 , 2 0 , 2 0 , 2 0 , 2 0 , 1 0 , 1 0 , 1 0 , 1 0 , 7 0 , 1 0 , 1 0 , 1 0 , 1 0 , 3 0 , 3 0 , 3 0 , 3 0 , 3 0 , 3 0 , 3 0 , 1 0 , 1 0 , 1 0 , 1 0 , 1 0 , 1 0 , 1 0 , 1 0 , 1 0 , 1 0 , 2 0 , 2 0 , 2 0 , 1 0 , 1 0 , 1 0 , 1 0 , 1 0 , 1 0 ;
1 0 , 1 0 , 1 0 , 1 0 , 1 0 , 1 0 , 1 0 , 1 0 , 1 0 , 2 0 , 2 0 , 2 0 , 2 0 , 2 0 , 2 0 , 1 0 , 1 0 , 1 0 , 1 0 , 1 0 , 1 0 , 1 0 , 1 0 , 1 0 , 3 0 , 3 0 , 3 0 , 3 0 , 3 0 , 3 0 , 1 0 , 1 0 , 1 0 , 1 0 , 1 0 , 1 0 , 1 0 , 5 0 , 1 0 , 1 0 , 2 0 , 2 0 , 2 0 , 1 0 , 1 0 , 1 0 , 1 0 , 3 0 , 3 0 , 3 0 ;
1 0 , 1 0 , 1 0 , 1 0 , 1 0 , 1 0 , 1 0 , 1 0 , 1 0 , 2 0 , 2 0 , 2 0 , 2 0 , 2 0 , 1 0 , 1 0 , 1 0 , 1 0 , 1 0 , 1 0 , 1 0 , 1 0 , 1 0 , 1 0 , 1 0 , 1 0 , 3 0 , 3 0 , 3 0 , 1 0 , 1 0 , 1 0 , 1 0 , 1 0 , 1 0 , 1 0 , 1 0 , 1 0 , 1 0 , 1 0 , 2 0 , 2 0 , 2 0 , 1 0 , 1 0 , 1 0 , 1 0 , 3 0 , 3 0 , 1 0 ;
0 0 , 0 0 , 1 0 , 1 0 , 0 0 , 0 0 , 0 0 , 1 0 , 1 0 , 1 0 , 2 0 , 2 0 , 2 0 , 2 0 , 1 0 , 1 0 , 1 0 , 1 0 , 1 0 , 1 0 , 1 0 , 1 0 , 1 0 , 1 0 , 1 0 , 1 0 , 1 0 , 3 0 , 1 0 , 1 0 , 1 0 , 1 0 , 1 0 , 1 0 , 5 0 , 1 0 , 1 0 , 1 0 , 1 0 , 2 0 , 2 0 , 2 0 , 1 0 , 1 0 , 1 0 , 1 0 , 5 0 , 3 0 , 3 0 , 1 0 ;
0 0 , 0 0 , 0 0 , 1 0 , 1 0 , 0 0 , 0 0 , 0 0 , 1 0 , 1 0 , 1 0 , 1 0 , 2 0 , 2 0 , 1 0 , 1 0 , 1 0 , 1 0 , 1 0 , 1 0 , 1 0 , 2 0 , 2 0 , 2 0 , 1 0 , 1 0 , 1 0 , 1 0 , 1 0 , 1 0 , 1 0 , 1 0 , 1 0 , 1 0 , 1 0 , 1 0 , 1 0 , 1 0 , 2 0 , 2 0 , 2 0 , 1 0 , 1 0 , 1 0 , 1 0 , 1 0 , 3 0 , 3 0 , 3 0 , 3 0 ;
0 0 , 0 0 , 0 0 , 0 0 , 1 0 , 1 0 , 0 0 , 0 0 , 0 0 , 0 0 , 1 0 , 1 0 , 1 0 , 1 0 , 1 0 , 3 0 , 3 0 , 3 0 , 1 0 , 1 0 , 1 0 , 2 0 , 2 0 , 2 0 , 1 0 , 1 0 , 1 0 , 1 0 , 1 0 , 1 0 , 1 0 , 1 0 , 1 0 , 1 0 , 1 0 , 1 0 , 1 0 , 2 0 , 2 0 , 2 0 , 1 0 , 1 0 , 1 0 , 1 0 , 1 0 , 3 0 , 3 0 , 3 0 , 3 0 , 3 0 ;
0 0 , 0 0 , 0 0 , 0 0 , 1 0 , 1 0 , 0 0 , 0 0 , 0 0 , 0 0 , 0 0 , 0 0 , 1 0 , 1 0 , 1 0 , 1 0 , 1 0 , 3 0 , 3 0 , 1 0 , 1 0 , 2 0 , 2 0 , 2 0 , 1 0 , 1 0 , 1 0 , 1 0 , 2 0 , 1 0 , 1 0 , 1 0 , 1 0 , 1 0 , 1 0 , 1 0 , 1 0 , 2 0 , 2 0 , 2 0 , 1 0 , 1 0 , 1 0 , 1 0 , 1 0 , 3 0 , 3 0 , 3 0 , 1 0 , 1 0 ;
0 0 , 0 0 , 0 0 , 1 0 , 1 0 , 0 0 , 0 0 , 0 0 , 0 0 , 0 0 , 0 0 , 1 0 , 1 0 , 1 0 , 1 0 , 1 0 , 1 0 , 1 0 , 3 0 , 3 0 , 1 0 , 1 0 , 1 0 , 1 0 , 1 0 , 1 0 , 1 0 , 2 0 , 2 0 , 2 0 , 1 0 , 1 0 , 1 0 , 1 0 , 1 0 , 1 0 , 1 0 , 2 0 , 2 0 , 2 0 , 1 0 , 1 0 , 1 0 , 1 0 , 1 0 , 3 0 , 3 0 , 1 0 , 1 0 , 1 0 ;
0 0 , 0 0 , 0 0 , 1 0 , 1 0 , 0 0 , 0 0 , 0 0 , 0 0 , 0 0 , 1 0 , 1 0 , 1 0 , 1 0 , 1 0 , 1 0 , 1 0 , 1 0 , 1 0 , 3 0 , 3 0 , 1 0 , 1 0 , 7 0 , 1 0 , 1 0 , 2 0 , 2 0 , 6 0 , 2 0 , 2 0 , 1 0 , 1 0 , 1 0 , 1 0 , 1 0 , 1 0 , 1 0 , 2 0 , 2 0 , 2 0 , 1 0 , 1 0 , 1 0 , 1 0 , 1 0 , 1 0 , 1 0 , 1 0 , 1 0 ;
0 0 , 0 0 , 1 0 , 1 0 , 0 0 , 0 0 , 0 0 , 0 0 , 0 0 , 1 0 , 1 0 , 1 0 , 1 0 , 1 0 , 1 0 , 1 0 , 1 0 , 1 0 , 1 0 , 1 0 , 1 0 , 1 0 , 1 0 , 1 0 , 1 0 , 1 0 , 1 0 , 2 0 , 2 0 , 2 0 , 1 0 , 1 0 , 1 0 , 1 0 , 1 0 , 1 0 , 1 0 , 1 0 , 1 0 , 2 0 , 2 0 , 2 0 , 1 0 , 1 0 , 1 0 , 5 0 , 1 0 , 1 0 , 1 0 , 1 0 ;
0 0 , 0 0 , 1 0 , 1 0 , 0 0 , 0 0 , 0 0 , 1 0 , 1 0 , 1 0 , 1 0 , 1 0 , 1 0 , 1 0 , 1 0 , 3 0 , 3 0 , 3 0 , 1 0 , 1 0 , 1 0 , 1 0 , 1 0 , 1 0 , 1 0 , 1 0 , 1 0 , 1 0 , 2 0 , 1 0 , 1 0 , 1 0 , 1 0 , 1 0 , 1 0 , 1 0 , 1 0 , 1 0 , 1 0 , 2 0 , 2 0 , 2 0 , 1 0 , 1 0 , 1 0 , 1 0 , 1 0 , 1 0 , 1 0 , 1 0 ;

0 0 , 0 0 , 0 0 , 0 0 , 0 0 , 0 0 , 0 0 , 0 0 , 0 0 , 0 0 , 0 0 , 0 0 , 0 0 , 0 0 , 0 0 , 0 0 , 0 0 , 0 0 , 0 0 , 0 0 , 0 0 , 0 0 , 0 0 , 0 0 , 0 0 , 0 0 , 0 0 , 0 0 , 0 0 , 0 0 , 0 0 , 0 0 , 0 0 , 0 0 , 0 0 , 0 0 , 0 0 , 0 0 , 0 0 , 0 0 , 0 0 , 0 0 , 0 0 , 0 0 , 0 0 , 0 0 , 0 0 , 0 0 , 0 0 , 0 0 ;
0 0 , 0 0 , 0 0 , 0 0 , 0 0 , 0 0 , 0 0 , 0 0 , 0 0 , 0 0 , 0 0 , 0 0 , 0 0 , 0 0 , 0 0 , 0 0 , 0 0 , 0 0 , 0 0 , 0 0 , 0 0 , 0 0 , 0 0 , 0 0 , 0 0 , 0 0 , 0 0 , 0 0 , 0 0 , 0 0 , 0 0 , 0 0 , 0 0 , 0 0 , 0 0 , 0 0 , 0 0 , 0 0 , 0 0 , 0 0 , 0 0 , 0 0 , 0 0 , 0 0 , 0 0 , 0 0 , 0 0 , 0 0 , 0 0 , 0 0 ;
0 0 , 0 0 , 0 0 , 0 0 , 0 0 , 0 0 , 0 0 , 0 0 , 0 0 , 0 0 , 0 0 , 0 0 , 0 0 , 0 0 , 0 0 , 0 0 , 0 0 , 0 0 , 0 0 , 0 0 , 0 0 , 0 0 , 0 0 , 0 0 , 0 0 , 0 0 , 0 0 , 0 0 , 0 0 , 0 0 , 0 0 , 0 0 , 0 0 , 0 0 , 0 0 , 0 0 , 0 0 , 0 0 , 0 0 , 0 0 , 0 0 , 0 0 , 0 0 , 0 0 , 0 0 , 0 0 , 0 0 , 0 0 , 0 0 , 0 0 ;
0 0 , 0 0 , 0 0 , 0 0 , 0 0 , 0 0 , 0 0 , 0 0 , 0 0 , 0 0 , 0 0 , 0 0 , 0 0 , 0 0 , 0 0 , 0 0 , 0 0 , 0 0 , 0 0 , 0 0 , 0 0 , 0 0 , 0 0 , 0 0 , 0 0 , 0 0 , 0 0 , 0 0 , 0 0 , 0 0 , 0 0 , 0 0 , 0 0 , 0 0 , 0 0 , 0 0 , 0 0 , 0 0 , 0 0 , 0 0 , 0 0 , 0 0 , 0 0 , 0 0 , 0 0 , 0 0 , 0 0 , 0 0 , 0 0 , 0 0 ;
0 0 , 0 0 , 0 0 , 0 0 , 0 0 , 0 0 , 0 0 , 0 0 , 0 0 , 0 0 , 0 0 , 0 0 , 0 0 , 0 0 , 0 0 , 0 0 , 0 0 , 0 0 , 0 0 , 0 0 , 0 0 , 0 0 , 0 0 , 0 0 , 0 0 , 0 0 , 0 0 , 0 0 , 0 0 , 0 0 , 0 0 , 0 0 , 0 0 , 0 0 , 0 0 , 0 0 , 0 0 , 0 0 , 0 0 , 0 0 , 0 0 , 0 0 , 0 0 , 0 0 , 0 0 , 0 0 , 0 0 , 0 0 , 0 0 , 0 0 ;
0 0 , 0 0 , 0 0 , 0 0 , 0 0 , 0 0 , 0 0 , 0 0 , 0 0 , 0 0 , 0 0 , 0 0 , 0 0 , 0 0 , 0 0 , 0 0 , 0 0 , 0 0 , 0 0 , 0 0 , 0 0 , 0 0 , 0 0 , 0 0 , 0 0 , 0 0 , 0 0 , 0 0 , 0 0 , 0 0 , 0 0 , 0 0 , 0 0 , 0 0 , 0 0 , 0 0 , 0 0 , 0 0 , 0 0 , 0 0 , 0 0 , 0 0 , 0 0 , 0 0 , 0 0 , 0 0 , 0 0 , 0 0 , 0 0 , 0 0 ;
0 0 , 0 0 , 0 0 , 0 0 , 0 0 , 0 0 , 0 0 , 0 0 , 0 0 , 0 0 , 0 0 , 0 0 , 0 0 , 0 0 , 0 0 , 0 0 , 0 0 , 0 0 , 0 0 , 0 0 , 0 0 , 0 0 , 0 0 , 0 0 , 0 0 , 0 0 , 0 0 , 0 0 , 0 0 , 0 0 , 0 0 , 0 0 , 0 0 , 0 0 , 0 0 , 0 0 , 0 0 , 0 0 , 0 0 , 0 0 , 0 0 , 0 0 , 0 0 , 0 0 , 0 0 , 0 0 , 0 0 , 0 0 , 0 0 , 0 0 ;
0 0 , 0 0 , 0 0 , 0 0 , 0 0 , 0 0 , 0 0 , 0 0 , 0 0 , 0 0 , 0 0 , 0 0 , 0 0 , 0 0 , 0 0 , 0 0 , 0 0 , 0 0 , 0 0 , 0 0 , 0 0 , 0 0 , 0 0 , 0 0 , 0 0 , 0 0 , 0 0 , 0 0 , 0 0 , 0 0 , 0 0 , 0 0 , 0 0 , 0 0 , 0 0 , 0 0 , 0 0 , 0 0 , 0 0 , 0 0 , 0 0 , 0 0 , 0 0 , 0 0 , 0 0 , 0 0 , 0 0 , 0 0 , 0 0 , 0 0 ;
0 0 , 0 0 , 0 0 , 0 0 , 0 0 , 0 0 , 0 0 , 0 0 , 0 0 , 0 0 , 0 0 , 0 0 , 0 0 , 0 0 , 0 0 , 0 0 , 0 0 , 0 0 , 0 0 , 0 0 , 0 0 , 0 0 , 0 0 , 0 0 , 0 0 , 0 0 , 0 0 , 0 0 , 0 0 , 0 0 , 0 0 , 0 0 , 0 0 , 0 0 , 0 0 , 0 0 , 0 0 , 0 0 , 0 0 , 0 0 , 0 0 , 0 0 , 0 0 , 0 0 , 0 0 , 0 0 , 0 0 , 0 0 , 0 0 , 0 0 ;
0 0 , 0 0 , 0 0 , 0 0 , 0 0 , 0 0 , 0 0 , 0 0 , 0 0 , 0 0 , 0 0 , 0 0 , 0 0 , 0 0 , 0 0 , 0 0 , 0 0 , 0 0 , 0 0 , 0 0 , 0 0 , 0 0 , 0 0 , 0 0 , 0 0 , 0 0 , 0 0 , 0 0 , 0 0 , 0 0 , 0 0 , 0 0 , 0 0 , 0 0 , 0 0 , 0 0 , 0 0 , 0 0 , 0 0 , 0 0 , 0 0 , 0 0 , 0 0 , 0 0 , 0 0 , 0 0 , 0 0 , 0 0 , 0 0 , 0 0 ;
0 0 , 0 0 , 0 0 , 0 0 , 0 0 , 0 0 , 0 0 , 0 0 , 0 0 , 0 0 , 0 0 , 0 0 , 0 0 , 0 0 , 0 0 , 0 0 , 0 0 , 0 0 , 0 0 , 0 0 , 0 0 , 0 0 , 0 0 , 0 0 , 0 0 , 0 0 , 0 0 , 0 0 , 0 0 , 0 0 , 0 0 , 0 0 , 0 0 , 0 0 , 0 0 , 0 0 , 0 0 , 0 0 , 0 0 , 0 0 , 0 0 , 0 0 , 0 0 , 0 0 , 0 0 , 0 0 , 0 0 , 0 0 , 0 0 , 0 0 ;
0 0 , 0 0 , 0 0 , 0 0 , 0 0 , 0 0 , 0 0 , 0 0 , 0 0 , 0 0 , 0 0 , 0 0 , 0 0 , 0 0 , 0 0 , 0 0 , 0 0 , 0 0 , 0 0 , 0 0 , 0 0 , 0 0 , 0 0 , 0 0 , 0 0 , 0 0 , 0 0 , 0 0 , 0 0 , 0 0 , 0 0 , 0 0 , 0 0 , 0 0 , 0 0 , 0 0 , 0 0 , 0 0 , 0 0 , 0 0 , 0 0 , 0 0 , 0 0 , 0 0 , 0 0 , 0 0 , 0 0 , 0 0 , 0 0 , 0 0 ;
0 0 , 0 0 , 0 0 , 0 0 , 0 0 , 0 0 , 0 0 , 0 0 , 0 0 , 0 0 , 0 0 , 0 0 , 0 0 , 0 0 , 0 0 , 0 0 , 0 0 , 0 0 , 0 0 , 0 0 , 0 0 , 0 0 , 0 0 , 0 0 , 0 0 , 0 0 , 0 0 , 0 0 , 0 0 , 0 0 , 0 0 , 0 0 , 0 0 , 0 0 , 0 0 , 0 0 , 0 0 , 0 0 , 0 0 , 0 0 , 0 0 , 0 0 , 0 0 , 0 0 , 0 0 , 0 0 , 0 0 , 0 0 , 0 0 , 0 0 ;
0 0 , 0 0 , 0 0 , 0 0 , 0 0 , 0 0 , 0 0 , 0 0 , 0 0 , 0 0 , 0 0 , 0 0 , 0 0 , 0 0 , 0 0 , 0 0 , 0 0 , 0 0 , 0 0 , 0 0 , 0 0 , 0 0 , 0 0 , 0 0 , 0 0 , 0 0 , 0 0 , 0 0 , 0 0 , 0 0 , 0 0 , 0 0 , 0 0 , 0 0 , 0 0 , 0 0 , 0 0 , 0 0 , 0 0 , 0 0 , 0 0 , 0 0 , 0 0 , 0 0 , 0 0 , 0 0 , 0 0 , 0 0 , 0 0 , 0 0 ;
0 0 , 0 0 , 0 0 , 0 0 , 0 0 , 0 0 , 0 0 , 0 0 , 0 0 , 0 0 , 0 0 , 0 0 , 0 0 , 0 0 , 0 0 , 0 0 , 0 0 , 0 0 , 0 0 , 0 0 , 0 0 , 0 0 , 0 0 , 0 0 , 0 0 , 0 0 , 0 0 , 0 0 , 0 0 , 0 0 , 0 0 , 0 0 , 0 0 , 0 0 , 0 0 , 0 0 , 0 0 , 0 0 , 0 0 , 0 0 , 0 0 , 0 0 , 0 0 , 0 0 , 0 0 , 0 0 , 0 0 , 0 0 , 0 0 , 0 0 ;
0 0 , 0 0 , 0 0 , 0 0 , 0 0 , 0 0 , 0 0 , 0 0 , 0 0 , 0 0 , 0 0 , 0 0 , 0 0 , 0 0 , 0 0 , 0 0 , 0 0 , 0 0 , 0 0 , 0 0 , 0 0 , 0 0 , 0 0 , 0 0 , 0 0 , 0 0 , 0 0 , 0 0 , 0 0 , 0 0 , 0 0 , 0 0 , 0 0 , 0 0 , 0 0 , 0 0 , 0 0 , 0 0 , 0 0 , 0 0 , 0 0 , 0 0 , 0 0 , 0 0 , 0 0 , 0 0 , 0 0 , 0 0 , 0 0 , 0 0 ;
0 0 , 0 0 , 0 0 , 0 0 , 0 0 , 0 0 , 0 0 , 0 0 , 0 0 , 0 0 , 0 0 , 0 0 , 0 0 , 0 0 , 0 0 , 0 0 , 0 0 , 0 0 , 0 0 , 0 0 , 0 0 , 0 0 , 0 0 , 0 0 , 0 0 , 0 0 , 0 0 , 0 0 , 0 0 , 0 0 , 0 0 , 0 0 , 0 0 , 0 0 , 0 0 , 0 0 , 0 0 , 0 0 , 0 0 , 0 0 , 0 0 , 0 0 , 0 0 , 0 0 , 0 0 , 0 0 , 0 0 , 0 0 , 0 0 , 0 0 ;
