35 50 4

0 0 , 0 0 , 1 0 , 1 0 , 1 0 , 1 0 , 1 0 , 1 0 , 1 0 , 1 0 , 1 0 , 1 0 , 1 0 , 1 0 , 1 0 , 1 0 , 1 0 , 1 0 , 1 0 , 1 0 , 1 0 , 1 0 , 1 0 , 1 0 , 1 0 , 1 0 , 1 0 , 1 0 , 1 0 , 1 0 , 1 0 , 1 0 , 1 0 , 1 0 , 1 0 , 1 0 , 1 0 , 1 0 , 1 0 , 1 0 , 1 0 , 1 0 , 1 0 , 1 0 , 1 0 , 1 0 , 1 0 , 1 0 , 1 0 , 1 0 ;
0 0 , 0 0 , 1 0 , 1 0 , 1 0 , 1 0 , 1 0 , 1 0 , 1 0 , 1 0 , 1 0 , 1 0 , 1 0 , 2 0 , 2 0 , 2 0 , 2 0 , 2 0 , 2 0 , 2 0 , 2 0 , 2 0 , 2 0 , 2 0 , 2 0 , 2 0 , 2 0 , 1 0 , 1 0 , 1 0 , 1 0 , 1 0 , 1 0 , 1 0 , 1 0 , 1 0 , 1 0 , 1 0 , 1 0 , 1 0 , 8 0 , 1 0 , 1 0 , 1 0 , 1 0 , 1 0 , 1 0 , 1 0 , 1 0 , 1 0 ;
1 0 , 1 0 , 1 0 , 1 0 , 7 0 , 1 0 , 1 0 , 1 0 , 1 0 , 1 0 , 1 0 , 2 0 , 2 0 , 2 0 , 2 0 , 6 0 , 2 0 , 2 0 , 2 0 , 2 0 , 2 0 , 2 0 , 2 0 , 2 0 , 2 0 , 2 0 , 2 0 , 1 0 , 1 0 , 1 0 , 1 0 , 1 0 , 1 0 , 1 0 , 1 0 , 1 0 , 1 0 , 1 0 , 1 0 , 1 0 , 1 0 , 1 0 , 1 0 , 1 0 , 9 3 , 1 0 , 1 0 , 1 0 , 1 0 , 1 0 ;
1 0 , 1 0 , 1 0 , 1 0 , 1 0 , 1 0 , 1 0 , 1 0 , 1 0 , 1 0 , 1 0 , 2 0 , 2 0 , 2 0 , 2 0 , 2 0 , 2 0 , 2 0 , 2 0 , 2 0 , 2 0 , 6 0 , 2 0 , 2 0 , 2 0 , 2 0 , 1 0 , 1 0 , 1 0 , 1 0 , 1 0 , 1 0 , 1 0 , 1 0 , 1 0 , 1 0 , 1 0 , 1 0 , 1 0 , 1 0 , 1 0 , 1 0 , 1 0 , 1 0 , 1 0 , 1 0 , 5 0 , 1 0 , 1 0 , 1 0 ;
1 0 , 1 0 , 9 1 , 1 0 , 1 0 , 1 0 , 1 0 , 1 0 , 1 0 , 1 0 , 1 0 , 1 0 , 1 0 , 1 0 , 2 0 , 2 0 , 2 0 , 2 0 , 2 0 , 2 0 , 2 0 , 2 0 , 2 0 , 2 0 , 1 0 , 1 0 , 1 0 , 1 0 , 1 0 , 1 0 , 1 0 , 1 0 , 1 0 , 0 0 , 0 0 , 1 0 , 1 0 , 1 0 , 1 0 , 1 0 , 1 0 , 1 0 , 1 0 , 1 0 , 1 0 , 1 0 , 1 0 , 1 0 , 1 0 , 1 0 ;
1 0 , 1 0 , 1 0 , 1 0 , 1 0 , 1 0 , 1 0 , 1 0 , 1 0 , 8 0 , 1 0 , 1 0 , 1 0 , 1 0 , 1 0 , 1 0 , 2 0 , 2 0 , 2 0 , 2 0 , 2 0 , 2 0 , 1 0 , 1 0 , 1 0 , 1 0 , 1 0 , 1 0 , 1 0 , 1 0 , 0 0 , 0 0 , 0 0 , 0 0 , 0 0 , 0 0 , 0 0 , 0 0 , 1 0 , 1 0 , 1 0 , 1 0 , 1 0 , 1 0 , 1 0 , 1 0 , 1 0 , 1 0 , 1 0 , 1 0 ;
1 0 , 1 0 , 1 0 , 1 0 , 1 0 , 1 0 , 1 0 , 1 0 , 1 0 , 1 0 , 1 0 , 1 0 , 1 0 , 1 0 , 1 0 , 1 0 , 2 0 , 2 0 , 1 0 , 1 0 , 1 0 , 1 0 , 1 0 , 1 0 , 1 0 , 1 0 , 1 0 , 1 0 , 1 0 , 0 0 , 0 0 , 0 0 , 0 0 , 0 0 , 0 0 , 0 0 , 0 0 , 0 0 , 0 0 , 1 0 , 1 0 , 1 0 , 1 0 , 1 0 , 1 0 , 1 0 , 1 0 , 1 0 , 1 0 , 1 0 ;
1 0 , 1 0 , 1 0 , 1 0 , 1 0 , 1 0 , 3 0 , 3 0 , 1 0 , 1 0 , 1 0 , 1 0 , 1 0 , 1 0 , 1 0 , 1 0 , 1 0 , 1 0 , 1 0 , 1 0 , 1 0 , 1 0 , 1 0 , 1 0 , 1 0 , 1 0 , 1 0 , 1 0 , 0 0 , 0 0 , 0 0 , 0 0 , 0 0 , 0 0 , 0 0 , 0 0 , 0 0 , 0 0 , 0 0 , 0 0 , 1 0 , 1 0 , 1 0 , 1 0 , 1 0 , 1 0 , 7 0 , 1 0 , 1 0 , 1 0 ;
1 0 , 1 0 , 1 0 , 1 0 , 3 0 , 3 0 , 3 0 , 3 0 , 3 0 , 3 0 , 1 0 , 1 0 , 1 0 , 1 0 , 1 0 , 1 0 , 1 0 , 1 0 , 1 0 , 1 0 , 1 0 , 1 0 , 1 0 , 1 0 , 1 0 , 1 0 , 1 0 , 1 0 , 1 0 , 1 0 , 0 0 , 0 0 , 0 0 , 0 0 , 0 0 , 0 0 , 0 0 , 1 0 , 1 0 , 1 0 , 1 0 , 1 0 , 1 0 , 1 0 , 1 0 , 1 0 , 1 0 , 1 0 , 1 0 , 1 0 ;
1 0 , 1 0 , 1 0 , 1 0 , 7 0 , 3 0 , 3 0 , 3 0 , 3 0 , 1 0 , 1 0 , 1 0 , 1 0 , 1 0 , 1 0 , 1 0 , 1 0 , 1 0 , 1 0 , 1 0 , 1 0 , 1 0 , 1 0 , 1 0 , 1 0 , 1 0 , 1 0 , 2 0 , 2 0 , 1 0 , 1 0 , 1 0 , 1 0 , 1 0 , 1 0 , 1 0 , 1 0 , 2 0 , 2 0 , 2 0 , 2 0 , 2 0 , 2 0 , 2 0 , 2 0 , 2 0 , 2 0 , 2 0 , 2 0 , 2 0 ;
1 0 , 1 0 , 1 0 , 1 0 , 1 0 , 1 0 , 1 0 , 1 0 , 1 0 , 1 0 , 1 0 , 0 0 , 0 0 , 0 0 , 0 0 , 1 0 , 1 0 , 1 0 , 1 0 , 1 0 , 1 0 , 1 0 , 1 0 , 1 0 , 1 0 , 1 0 , 1 0 , 2 0 , 2 0 , 2 0 , 2 0 , 2 0 , 2 0 , 2 0 , 2 0 , 2 0 , 2 0 , 2 0 , 6 0 , 2 0 , 2 0 , 2 0 , 2 0 , 2 0 , 2 0 , 2 0 , 2 0 , 2 0 , 2 0 , 2 0 ;
1 0 , 1 0 , 1 0 , 1 0 , 1 0 , 1 0 , 1 0 , 1 0 , 1 0 , 0 0 , 0 0 , 0 0 , 0 0 , 0 0 , 0 0 , 0 0 , 0 0 , 1 0 , 1 0 , 1 0 , 1 0 , 1 0 , 1 0 , 1 0 , 1 0 , 1 0 , 1 0 , 2 0 , 2 0 , 2 0 , 2 0 , 2 0 , 2 0 , 2 0 , 2 0 , 2 0 , 2 0 , 2 0 , 2 0 , 2 0 , 2 0 , 2 0 , 2 0 , 1 0 , 1 0 , 1 0 , 1 0 , 1 0 , 1 0 , 1 0 ;
1 0 , 1 0 , 1 0 , 1 0 , 1 0 , 1 0 , 0 0 , 0 0 , 0 0 , 0 0 , 0 0 , 0 0 , 0 0 , 0 0 , 0 0 , 0 0 , 0 0 , 0 0 , 0 0 , 0 0 , 1 0 , 1 0 , 1 0 , 1 0 , 1 0 , 1 0 , 1 0 , 2 0 , 2 0 , 2 0 , 2 0 , 1 0 , 1 0 , 1 0 , 1 0 , 1 0 , 1 0 , 1 0 , 1 0 , 1 0 , 1 0 , 1 0 , 1 0 , 1 0 , 1 0 , 1 0 , 1 0 , 1 0 , 1 0 , 1 0 ;
1 0 , 1 0 , 1 0 , 1 0 , 1 0 , 1 0 , 1 0 , 1 0 , 0 0 , 0 0 , 0 0 , 0 0 , 0 0 , 0 0 , 0 0 , 0 0 , 0 0 , 1 0 , 1 0 , 1 0 , 1 0 , 1 0 , 1 0 , 1 0 , 1 0 , 1 0 , 1 0 , 2 0 , 2 0 , 2 0 , 1 0 , 1 0 , 1 0 , 1 0 , 1 0 , 1 0 , 1 0 , 1 0 , 1 0 , 1 0 , 1 0 , 1 0 , 1 0 , 1 0 , 1 0 , 1 0 , 1 0 , 1 0 , 1 0 , 1 0 ;
1 0 , 1 0 , 1 0 , 1 0 , 1 0 , 1 0 , 1 0 , 1 0 , 1 0 , 1 0 , 0 0 , 0 0 , 0 0 , 0 0 , 0 0 , 0 0 , 0 0 , 0 0 , 1 0 , 1 0 , 1 0 , 1 0 , 1 0 , 1 0 , 1 0 , 1 0 , 1 0 , 2 0 , 2 0 , 1 0 , 1 0 , 1 0 , 1 0 , 1 0 , 1 0 , 1 0 , 1 0 , 1 0 , 1 0 , 1 0 , 1 0 , 1 0 , 1 0 , 1 0 , 1 0 , 1 0 , 1 0 , 1 0 , 1 0 , 1 0 ;
1 0 , 1 0 , 1 0 , 1 0 , 1 0 , 1 0 , 1 0 , 1 0 , 1 0 , 1 0 , 1 0 , 0 0 , 0 0 , 0 0 , 0 0 , 0 0 , 0 0 , 0 0 , 0 0 , 1 0 , 1 0 , 1 0 , 8 0 , 1 0 , 1 0 , 1 0 , 1 0 , 2 0 , 2 0 , 1 0 , 1 0 , 1 0 , 1 0 , 1 0 , 1 0 , 1 0 , 1 0 , 1 0 , 1 0 , 1 0 , 1 0 , 1 0 , 1 0 , 1 0 , 1 0 , 1 0 , 1 0 , 1 0 , 1 0 , 1 0 ;
1 0 , 1 0 , 1 0 , 1 0 , 1 0 , 1 0 , 1 0 , 1 0 , 1 0 , 0 0 , 0 0 , 0 0 , 0 0 , 5 0 , 0 0 , 0 0 , 0 0 , 1 0 , 1 0 , 1 0 , 1 0 , 1 0 , 1 0 , 1 0 , 1 0 , 1 0 , 1 0 , 2 0 , 2 0 , 1 0 , 1 0 , 1 0 , 1 0 , 1 0 , 1 0 , 1 0 , 1 0 , 1 0 , 1 0 , 1 0 , 1 0 , 1 0 , 1 0 , 1 0 , 1 0 , 1 0 , 1 0 , 1 0 , 1 0 , 1 0 ;
1 0 , 1 0 , 1 0 , 1 0 , 1 0 , 1 0 , 1 0 , 1 0 , 1 0 , 1 0 , 1 0 , 0 0 , 0 0 , 0 0 , 0 0 , 0 0 , 0 0 , 0 0 , 1 0 , 1 0 , 1 0 , 1 0 , 1 0 , 1 0 , 1 0 , 1 0 , 1 0 , 2 0 , 2 0 , 1 0 , 1 0 , 1 0 , 1 0 , 1 0 , 0 0 , 0 0 , 0 0 , 1 0 , 1 0 , 1 0 , 1 0 , 0 0 , 0 0 , 0 0 , 1 0 , 1 0 , 1 0 , 1 0 , 1 0 , 1 0 ;
1 0 , 1 0 , 1 0 , 1 0 , 5 0 , 1 0 , 1 0 , 1 0 , 1 0 , 1 0 , 1 0 , 1 0 , 0 0 , 0 0 , 0 0 , 0 0 , 0 0 , 1 0 , 1 0 , 1 0 , 1 0 , 1 0 , 1 0 , 1 0 , 1 0 , 1 0 , 1 0 , 2 0 , 2 0 , 1 0 , 1 0 , 1 0 , 1 0 , 1 0 , 0 0 , 0 0 , 0 0 , 0 0 , 0 0 , 0 0 , 0 0 , 0 0 , 0 0 , 0 0 , 1 0 , 1 0 , 1 0 , 1 0 , 1 0 , 1 0 ;
1 0 , 1 0 , 1 0 , 1 0 , 1 0 , 1 0 , 1 0 , 1 0 , 1 0 , 1 0 , 1 0 , 1 0 , 1 0 , 1 0 , 1 0 , 1 0 , 1 0 , 1 0 , 1 0 , 1 0 , 1 0 , 1 0 , 1 0 , 1 0 , 1 0 , 2 0 , 2 0 , 2 0 , 2 0 , 1 0 , 1 0 , 1 0 , 1 0 , 1 0 , 1 0 , 1 0 , 0 0 , 0 0 , 0 0 , 0 0 , 0 0 , 0 0 , 0 0 , 1 0 , 1 0 , 1 0 , 1 0 , 1 0 , 1 0 , 1 0 ;
1 0 , 1 0 , 1 0 , 1 0 , 1 0 , 1 0 , 1 0 , 1 0 , 1 0 , 1 0 , 1 0 , 1 0 , 1 0 , 1 0 , 1 0 , 1 0 , 1 0 , 1 0 , 1 0 , 1 0 , 1 0 , 1 0 , 1 0 , 1 0 , 1 0 , 2 0 , 2 0 , 2 0 , 2 0 , 1 0 , 1 0 , 1 0 , 1 0 , 1 0 , 1 0 , 1 0 , 1 0 , 1 0 , 0 0 , 0 0 , 0 0 , 0 0 , 1 0 , 1 0 , 1 0 , 1 0 , 1 0 , 1 0 , 1 0 , 1 0 ;
1 0 , 1 0 , 1 0 , 1 0 , 1 0 , 1 0 , 1 0 , 1 0 , 3 0 , 3 0 , 3 0 , 3 0 , 3 0 , 3 0 , 3 0 , 3 0 , 3 0 , 3 0 , 3 0 , 1 0 , 1 0 , 2 0 , 2 0 , 2 0 , 2 0 , 2 0 , 2 0 , 2 0 , 2 0 , 2 0 , 1 0 , 1 0 , 1 0 , 1 0 , 1 0 , 1 0 , 1 0 , 1 0 , 1 0 , 0 0 , 0 0 , 1 0 , 1 0 , 1 0 , 1 0 , 1 0 , 1 0 , 1 0 , 1 0 , 1 0 ;
1 0 , 1 0 , 1 0 , 1 0 , 1 0 , 1 0 , 3 0 , 3 0 , 3 0 , 3 0 , 3 0 , 3 0 , 3 0 , 3 0 , 3 0 , 3 0 , 3 0 , 3 0 , 3 0 , 1 0 , 1 0 , 2 0 , 2 0 , 2 0 , 2 0 , 2 0 , 6 0 , 2 0 , 2 0 , 2 0 , 1 0 , 1 0 , 1 0 , 1 0 , 1 0 , 1 0 , 1 0 , 1 0 , 1 0 , 1 0 , 1 0 , 1 0 , 1 0 , 1 0 , 1 0 , 1 0 , 1 0 , 1 0 , 1 0 , 1 0 ;
1 0 , 1 0 , 1 0 , 1 0 , 1 0 , 1 0 , 1 0 , 3 0 , 3 0 , 3 0 , 3 0 , 3 0 , 3 0 , 3 0 , 3 0 , 3 0 , 3 0 , 3 0 , 1 0 , 1 0 , 1 0 , 1 0 , 1 0 , 2 0 , 2 0 , 2 0 , 2 0 , 2 0 , 2 0 , 2 0 , 1 0 , 1 0 , 1 0 , 1 0 , 1 0 , 1 0 , 1 0 , 1 0 , 1 0 , 1 0 , 1 0 , 1 0 , 1 0 , 1 0 , 2 0 , 2 0 , 2 0 , 2 0 , 1 0 , 1 0 ;
1 0 , 8 0 , 1 0 , 1 0 , 1 0 , 1 0 , 1 0 , 1 0 , 1 0 , 3 0 , 3 0 , 3 0 , 3 0 , 3 0 , 3 0 , 3 0 , 1 0 , 1 0 , 1 0 , 1 0 , 1 0 , 1 0 , 1 0 , 1 0 , 1 0 , 2 0 , 2 0 , 2 0 , 1 0 , 1 0 , 1 0 , 1 0 , 1 0 , 8 0 , 1 0 , 1 0 , 1 0 , 1 0 , 1 0 , 1 0 , 1 0 , 1 0 , 2 0 , 2 0 , 2 0 , 6 0 , 2 0 , 2 0 , 1 0 , 1 0 ;
1 0 , 1 0 , 1 0 , 1 0 , 1 0 , 1 0 , 1 0 , 1 0 , 1 0 , 1 0 , 1 0 , 1 0 , 1 0 , 1 0 , 1 0 , 1 0 , 1 0 , 1 0 , 1 0 , 1 0 , 1 0 , 1 0 , 1 0 , 1 0 , 1 0 , 1 0 , 1 0 , 1 0 , 1 0 , 1 0 , 1 0 , 1 0 , 1 0 , 1 0 , 1 0 , 1 0 , 1 0 , 1 0 , 1 0 , 1 0 , 1 0 , 1 0 , 2 0 , 2 0 , 2 0 , 2 0 , 2 0 , 2 0 , 1 0 , 1 0 ;
1 0 , 1 0 , 1 0 , 1 0 , 1 0 , 1 0 , 1 0 , 1 0 , 1 0 , 1 0 , 1 0 , 1 0 , 1 0 , 1 0 , 1 0 , 1 0 , 1 0 , 1 0 , 1 0 , 1 0 , 8 0 , 1 0 , 1 0 , 1 0 , 1 0 , 1 0 , 1 0 , 1 0 , 1 0 , 1 0 , 1 0 , 1 0 , 1 0 , 1 0 , 1 0 , 1 0 , 1 0 , 1 0 , 2 0 , 2 0 , 2 0 , 2 0 , 2 0 , 2 0 , 2 0 , 2 0 , 2 0 , 2 0 , 1 0 , 1 0 ;
1 0 , 1 0 , 1 0 , 1 0 , 1 0 , 1 0 , 1 0 , 5 0 , 1 0 , 1 0 , 1 0 , 1 0 , 1 0 , 1 0 , 1 0 , 1 0 , 1 0 , 1 0 , 1 0 , 1 0 , 1 0 , 1 0 , 1 0 , 1 0 , 1 0 , 1 0 , 0 0 , 0 0 , 0 0 , 0 0 , 0 0 , 1 0 , 1 0 , 1 0 , 1 0 , 1 0 , 1 0 , 1 0 , 2 0 , 2 0 , 2 0 , 2 0 , 2 0 , 2 0 , 6 0 , 2 0 , 2 0 , 2 0 , 2 0 , 2 0 ;
1 0 , 1 0 , 1 0 , 9 4 , 1 0 , 1 0 , 1 0 , 1 0 , 1 0 , 1 0 , 1 0 , 1 0 , 1 0 , 7 0 , 1 0 , 1 0 , 1 0 , 1 0 , 1 0 , 1 0 , 1 0 , 1 0 , 1 0 , 1 0 , 1 0 , 0 0 , 0 0 , 0 0 , 0 0 , 0 0 , 0 0 , 0 0 , 1 0 , 1 0 , 1 0 , 1 0 , 1 0 , 1 0 , 1 0 , 1 0 , 2 0 , 2 0 , 2 0 , 2 0 , 2 0 , 2 0 , 2 0 , 2 0 , 2 0 , 2 0 ;
1 0 , 1 0 , 1 0 , 1 0 , 1 0 , 1 0 , 1 0 , 1 0 , 1 0 , 1 0 , 1 0 , 1 0 , 1 0 , 1 0 , 1 0 , 1 0 , 1 0 , 1 0 , 5 0 , 1 0 , 1 0 , 1 0 , 1 0 , 1 0 , 1 0 , 0 0 , 0 0 , 0 0 , 0 0 , 0 0 , 0 0 , 1 0 , 1 0 , 1 0 , 1 0 , 1 0 , 1 0 , 1 0 , 1 0 , 1 0 , 1 0 , 1 0 , 2 0 , 2 0 , 2 0 , 2 0 , 2 0 , 1 0 , 1 0 , 1 0 ;
1 0 , 1 0 , 1 0 , 1 0 , 1 0 , 1 0 , 1 0 , 1 0 , 1 0 , 1 0 , 1 0 , 1 0 , 1 0 , 1 0 , 1 0 , 1 0 , 1 0 , 1 0 , 1 0 , 1 0 , 1 0 , 1 0 , 1 0 , 1 0 , 1 0 , 0 0 , 0 0 , 0 0 , 0 0 , 1 0 , 1 0 , 1 0 , 1 0 , 1 0 , 1 0 , 1 0 , 1 0 , 8 0 , 1 0 , 1 0 , 1 0 , 1 0 , 1 0 , 1 0 , 1 0 , 1 0 , 1 0 , 1 0 , 1 0 , 1 0 ;
1 0 , 1 0 , 7 0 , 1 0 , 1 0 , 1 0 , 1 0 , 1 0 , 3 0 , 3 0 , 3 0 , 3 0 , 3 0 , 3 0 , 1 0 , 1 0 , 1 0 , 1 0 , 1 0 , 1 0 , 1 0 , 1 0 , 1 0 , 1 0 , 1 0 , 1 0 , 1 0 , 0 0 , 0 0 , 1 0 , 1 0 , 1 0 , 1 0 , 1 0 , 1 0 , 1 0 , 1 0 , 1 0 , 1 0 , 1 0 , 1 0 , 1 0 , 1 0 , 1 0 , 1 0 , 0 0 , 0 0 , 0 0 , 0 0 , 0 0 ;
1 0 , 1 0 , 1 0 , 1 0 , 1 0 , 3 0 , 3 0 , 3 0 , 3 0 , 3 0 , 3 0 , 3 0 , 3 0 , 3 0 , 3 0 , 3 0 , 1 0 , 1 0 , 1 0 , 1 0 , 1 0 , 1 0 , 1 0 , 1 0 , 1 0 , 1 0 , 1 0 , 1 0 , 1 0 , 1 0 , 1 0 , 1 0 , 1 0 , 9 2 , 1 0 , 1 0 , 1 0 , 1 0 , 1 0 , 1 0 , 1 0 , 1 0 , 0 0 , 0 0 , 0 0 , 0 0 , 5 0 , 0 0 , 0 0 , 0 0 ;
1 0 , 3 0 , 3 0 , 3 0 , 3 0 , 3 0 , 3 0 , 3 0 , 3 0 , 3 0 , 3 0 , 3 0 , 3 0 , 3 0 , 3 0 , 3 0 , 3 0 , 3 0 , 3 0 , 1 0 , 1 0 , 1 0 , 1 0 , 1 0 , 1 0 , 1 0 , 1 0 , 1 0 , 1 0 , 1 0 , 1 0 , 1 0 , 1 0 , 1 0 , 1 0 , 1 0 , 1 0 , 1 0 , 1 0 , 0 0 , 0 0 , 0 0 , 0 0 , 0 0 , 0 0 , 0 0 , 0 0 , 0 0 , 0 0 , 0 0 ;
1 0 , 1 0 , 1 0 , 1 0 , 3 0 , 3 0 , 3 0 , 3 0 , 3 0 , 3 0 , 3 0 , 3 0 , 3 0 , 3 0 , 3 0 , 1 0 , 1 0 , 1 0 , 1 0 , 1 0 , 1 0 , 1 0 , 1 0 , 1 0 , 1 0 , 1 0 , 1 0 , 1 0 , 5 0 , 1 0 , 1 0 , 1 0 , 1 0 , 1 0 , 1 0 , 1 0 , 1 0 , 0 0 , 0 0 , 0 0 , 0 0 , 0 0 , 0 0 , 0 0 , 0 0 , 0 0 , 0 0 , 0 0 , 0 0 , 0 0 ;

0 0 , 0 0 , 0 0 , 0 0 , 0 0 , 0 0 , 0 0 , 0 0 , 0 0 , 0 0 , 0 0 , 0 0 , 0 0 , 0 0 , 0 0 , 0 0 , 0 0 , 0 0 , 0 0 , 0 0 , 0 0 , 0 0 , 0 0 , 0 0 , 0 0 , 0 0 , 0 0 , 0 0 , 0 0 , 0 0 , 0 0 , 0 0 , 0 0 , 0 0 , 0 0 , 0 0 , 0 0 , 0 0 , 0 0 , 0 0 , 0 0 , 0 0 , 0 0 , 0 0 , 0 0 , 0 0 , 0 0 , 0 0 , 0 0 , 0 0 ;
0 0 , 0 0 , 0 0 , 0 0 , 0 0 , 0 0 , 0 0 , 0 0 , 0 0 , 0 0 , 0 0 , 0 0 , 0 0 , 0 0 , 0 0 , 0 0 , 0 0 , 0 0 , 0 0 , 0 0 , 0 0 , 0 0 , 0 0 , 0 0 , 0 0 , 0 0 , 0 0 , 0 0 , 0 0 , 0 0 , 0 0 , 0 0 , 0 0 , 0 0 , 0 0 , 0 0 , 0 0 , 0 0 , 0 0 , 0 0 , 0 0 , 0 0 , 0 0 , 0 0 , 0 0 , 0 0 , 0 0 , 0 0 , 0 0 , 0 0 ;
0 0 , 0 0 , 0 0 , 0 0 , 0 0 , 0 0 , 0 0 , 0 0 , 0 0 , 0 0 , 0 0 , 0 0 , 0 0 , 0 0 , 0 0 , 0 0 , 0 0 , 0 0 , 0 0 , 0 0 , 0 0 , 0 0 , 0 0 , 0 0 , 0 0 , 0 0 , 0 0 , 0 0 , 0 0 , 0 0 , 0 0 , 0 0 , 0 0 , 0 0 , 0 0 , 0 0 , 0 0 , 0 0 , 0 0 , 0 0 , 0 0 , 0 0 , 0 0 , 0 0 , 0 0 , 0 0 , 0 0 , 0 0 , 0 0 , 0 0 ;
0 0 , 0 0 , 0 0 , 0 0 , 0 0 , 0 0 , 0 0 , 0 0 , 0 0 , 0 0 , 0 0 , 0 0 , 0 0 , 0 0 , 0 0 , 0 0 , 0 0 , 0 0 , 0 0 , 0 0 , 0 0 , 0 0 , 0 0 , 0 0 , 0 0 , 0 0 , 0 0 , 0 0 , 0 0 , 0 0 , 0 0 , 0 0 , 0 0 , 0 0 , 0 0 , 0 0 , 0 0 , 0 0 , 0 0 , 0 0 , 0 0 , 0 0 , 0 0 , 0 0 , 0 0 , 0 0 , 0 0 , 0 0 , 0 0 , 0 0 ;
0 0 , 0 0 , 0 0 , 0 0 , 0 0 , 0 0 , 0 0 , 0 0 , 0 0 , 0 0 , 0 0 , 0 0 , 0 0 , 0 0 , 0 0 , 0 0 , 0 0 , 0 0 , 0 0 , 0 0 , 0 0 , 0 0 , 0 0 , 0 0 , 0 0 , 0 0 , 0 0 , 0 0 , 0 0 , 0 0 , 0 0 , 0 0 , 0 0 , 0 0 , 0 0 , 0 0 , 0 0 , 0 0 , 0 0 , 0 0 , 0 0 , 0 0 , 0 0 , 0 0 , 0 0 , 0 0 , 0 0 , 0 0 , 0 0 , 0 0 ;
0 0 , 0 0 , 0 0 , 0 0 , 0 0 , 0 0 , 0 0 , 0 0 , 0 0 , 0 0 , 0 0 , 0 0 , 0 0 , 0 0 , 0 0 , 0 0 , 0 0 , 0 0 , 0 0 , 0 0 , 0 0 , 0 0 , 0 0 , 0 0 , 0 0 , 0 0 , 0 0 , 0 0 , 0 0 , 0 0 , 0 0 , 0 0 , 0 0 , 0 0 , 0 0 , 0 0 , 0 0 , 0 0 , 0 0 , 0 0 , 0 0 , 0 0 , 0 0 , 0 0 , 0 0 , 0 0 , 0 0 , 0 0 , 0 0 , 0 0 ;
0 0 , 0 0 , 0 0 , 0 0 , 0 0 , 0 0 , 0 0 , 0 0 , 0 0 , 0 0 , 0 0 , 0 0 , 0 0 , 0 0 , 0 0 , 0 0 , 0 0 , 0 0 , 0 0 , 0 0 , 0 0 , 0 0 , 0 0 , 0 0 , 0 0 , 0 0 , 0 0 , 0 0 , 0 0 , 0 0 , 0 0 , 0 0 , 0 0 , 0 0 , 0 0 , 0 0 , 0 0 , 0 0 , 0 0 , 0 0 , 0 0 , 0 0 , 0 0 , 0 0 , 0 0 , 0 0 , 0 0 , 0 0 , 0 0 , 0 0 ;
0 0 , 0 0 , 0 0 , 0 0 , 0 0 , 0 0 , 0 0 , 0 0 , 0 0 , 0 0 , 0 0 , 0 0 , 0 0 , 0 0 , 0 0 , 0 0 , 0 0 , 0 0 , 0 0 , 0 0 , 0 0 , 0 0 , 0 0 , 0 0 , 0 0 , 0 0 , 0 0 , 0 0 , 0 0 , 0 0 , 0 0 , 0 0 , 0 0 , 0 0 , 0 0 , 0 0 , 0 0 , 0 0 , 0 0 , 0 0 , 0 0 , 0 0 , 0 0 , 0 0 , 0 0 , 0 0 , 0 0 , 0 0 , 0 0 , 0 0 ;
0 0 , 0 0 , 0 0 , 0 0 , 0 0 , 0 0 , 0 0 , 0 0 , 0 0 , 0 0 , 0 0 , 0 0 , 0 0 , 0 0 , 0 0 , 0 0 , 0 0 , 0 0 , 0 0 , 0 0 , 0 0 , 0 0 , 0 0 , 0 0 , 0 0 , 0 0 , 0 0 , 0 0 , 0 0 , 0 0 , 0 0 , 0 0 , 0 0 , 0 0 , 0 0 , 0 0 , 0 0 , 0 0 , 0 0 , 0 0 , 0 0 , 0 0 , 0 0 , 0 0 , 0 0 , 0 0 , 0 0 , 0 0 , 0 0 , 0 0 ;
0 0 , 0 0 , 0 0 , 0 0 , 0 0 , 0 0 , 0 0 , 0 0 , 0 0 , 0 0 , 0 0 , 0 0 , 0 0 , 0 0 , 0 0 , 0 0 , 0 0 , 0 0 , 0 0 , 0 0 , 0 0 , 0 0 , 0 0 , 0 0 , 0 0 , 0 0 , 0 0 , 0 0 , 0 0 , 0 0 , 0 0 , 0 0 , 0 0 , 0 0 , 0 0 , 0 0 , 0 0 , 0 0 , 0 0 , 0 0 , 0 0 , 0 0 , 0 0 , 0 0 , 0 0 , 0 0 , 0 0 , 0 0 , 0 0 , 0 0 ;
0 0 , 0 0 , 0 0 , 0 0 , 0 0 , 0 0 , 0 0 , 0 0 , 0 0 , 0 0 , 0 0 , 0 0 , 0 0 , 0 0 , 0 0 , 0 0 , 0 0 , 0 0 , 0 0 , 0 0 , 0 0 , 0 0 , 0 0 , 0 0 , 0 0 , 0 0 , 0 0 , 0 0 , 0 0 , 0 0 , 0 0 , 0 0 , 0 0 , 0 0 , 0 0 , 0 0 , 0 0 , 0 0 , 0 0 , 0 0 , 0 0 , 0 0 , 0 0 , 0 0 , 0 0 , 0 0 , 0 0 , 0 0 , 0 0 , 0 0 ;
0 0 , 0 0 , 0 0 , 0 0 , 0 0 , 0 0 , 0 0 , 0 0 , 0 0 , 0 0 , 0 0 , 0 0 , 0 0 , 0 0 , 0 0 , 0 0 , 0 0 , 0 0 , 0 0 , 0 0 , 0 0 , 0 0 , 0 0 , 0 0 , 0 0 , 0 0 , 0 0 , 0 0 , 0 0 , 0 0 , 0 0 , 0 0 , 0 0 , 0 0 , 0 0 , 0 0 , 0 0 , 0 0 , 0 0 , 0 0 , 0 0 , 0 0 , 0 0 , 0 0 , 0 0 , 0 0 , 0 0 , 0 0 , 0 0 , 0 0 ;
0 0 , 0 0 , 0 0 , 0 0 , 0 0 , 0 0 , 0 0 , 0 0 , 0 0 , 0 0 , 0 0 , 0 0 , 0 0 , 0 0 , 0 0 , 0 0 , 0 0 , 0 0 , 0 0 , 0 0 , 0 0 , 0 0 , 0 0 , 0 0 , 0 0 , 0 0 , 0 0 , 0 0 , 0 0 , 0 0 , 0 0 , 0 0 , 0 0 , 0 0 , 0 0 , 0 0 , 0 0 , 0 0 , 0 0 , 0 0 , 0 0 , 0 0 , 0 0 , 0 0 , 0 0 , 0 0 , 0 0 , 0 0 , 0 0 , 0 0 ;
0 0 , 0 0 , 0 0 , 0 0 , 0 0 , 0 0 , 0 0 , 0 0 , 0 0 , 0 0 , 0 0 , 0 0 , 0 0 , 0 0 , 0 0 , 0 0 , 0 0 , 0 0 , 0 0 , 0 0 , 0 0 , 0 0 , 0 0 , 0 0 , 0 0 , 0 0 , 0 0 , 0 0 , 0 0 , 0 0 , 0 0 , 0 0 , 0 0 , 0 0 , 0 0 , 0 0 , 0 0 , 0 0 , 0 0 , 0 0 , 0 0 , 0 0 , 0 0 , 0 0 , 0 0 , 0 0 , 0 0 , 0 0 , 0 0 , 0 0 ;
0 0 , 0 0 , 0 0 , 0 0 , 0 0 , 0 0 , 0 0 , 0 0 , 0 0 , 0 0 , 0 0 , 0 0 , 0 0 , 0 0 , 0 0 , 0 0 , 0 0 , 0 0 , 0 0 , 0 0 , 0 0 , 0 0 , 0 0 , 0 0 , 0 0 , 0 0 , 0 0 , 0 0 , 0 0 , 0 0 , 0 0 , 0 0 , 0 0 , 0 0 , 0 0 , 0 0 , 0 0 , 0 0 , 0 0 , 0 0 , 0 0 , 0 0 , 0 0 , 0 0 , 0 0 , 0 0 , 0 0 , 0 0 , 0 0 , 0 0 ;
0 0 , 0 0 , 0 0 , 0 0 , 0 0 , 0 0 , 0 0 , 0 0 , 0 0 , 0 0 , 0 0 , 0 0 , 0 0 , 0 0 , 0 0 , 0 0 , 0 0 , 0 0 , 0 0 , 0 0 , 0 0 , 0 0 , 0 0 , 0 0 , 0 0 , 0 0 , 0 0 , 0 0 , 0 0 , 0 0 , 0 0 , 0 0 , 0 0 , 0 0 , 0 0 , 0 0 , 0 0 , 0 0 , 0 0 , 0 0 , 0 0 , 0 0 , 0 0 , 0 0 , 0 0 , 0 0 , 0 0 , 0 0 , 0 0 , 0 0 ;
0 0 , 0 0 , 0 0 , 0 0 , 0 0 , 0 0 , 0 0 , 0 0 , 0 0 , 0 0 , 0 0 , 0 0 , 0 0 , 0 0 , 0 0 , 0 0 , 0 0 , 0 0 , 0 0 , 0 0 , 0 0 , 0 0 , 0 0 , 0 0 , 0 0 , 0 0 , 0 0 , 0 0 , 0 0 , 0 0 , 0 0 , 0 0 , 0 0 , 0 0 , 0 0 , 0 0 , 0 0 , 0 0 , 0 0 , 0 0 , 0 0 , 0 0 , 0 0 , 0 0 , 0 0 , 0 0 , 0 0 , 0 0 , 0 0 , 0 0 ;
0 0 , 0 0 , 0 0 , 0 0 , 0 0 , 0 0 , 0 0 , 0 0 , 0 0 , 0 0 , 0 0 , 0 0 , 0 0 , 0 0 , 0 0 , 0 0 , 0 0 , 0 0 , 0 0 , 0 0 , 0 0 , 0 0 , 0 0 , 0 0 , 0 0 , 0 0 , 0 0 , 0 0 , 0 0 , 0 0 , 0 0 , 0 0 , 0 0 , 0 0 , 0 0 , 0 0 , 0 0 , 0 0 , 0 0 , 0 0 , 0 0 , 0 0 , 0 0 , 0 0 , 0 0 , 0 0 , 0 0 , 0 0 , 0 0 , 0 0 ;
0 0 , 0 0 , 0 0 , 0 0 , 0 0 , 0 0 , 0 0 , 0 0 , 0 0 , 0 0 , 0 0 , 0 0 , 0 0 , 0 0 , 0 0 , 0 0 , 0 0 , 0 0 , 0 0 , 0 0 , 0 0 , 0 0 , 0 0 , 0 0 , 0 0 , 0 0 , 0 0 , 0 0 , 0 0 , 0 0 , 0 0 , 0 0 , 0 0 , 0 0 , 0 0 , 0 0 , 0 0 , 0 0 , 0 0 , 0 0 , 0 0 , 0 0 , 0 0 , 0 0 , 0 0 , 0 0 , 0 0 , 0 0 , 0 0 , 0 0 ;
0 0 , 0 0 , 0 0 , 0 0 , 0 0 , 0 0 , 0 0 , 0 0 , 0 0 , 0 0 , 0 0 , 0 0 , 0 0 , 0 0 , 0 0 , 0 0 , 0 0 , 0 0 , 0 0 , 0 0 , 0 0 , 0 0 , 0 0 , 0 0 , 0 0 , 0 0 , 0 0 , 0 0 , 0 0 , 0 0 , 0 0 , 0 0 , 0 0 , 0 0 , 0 0 , 0 0 , 0 0 , 0 0 , 0 0 , 0 0 , 0 0 , 0 0 , 0 0 , 0 0 , 0 0 , 0 0 , 0 0 , 0 0 , 0 0 , 0 0 ;
0 0 , 0 0 , 0 0 , 0 0 , 0 0 , 0 0 , 0 0 , 0 0 , 0 0 , 0 0 , 0 0 , 0 0 , 0 0 , 0 0 , 0 0 , 0 0 , 0 0 , 0 0 , 0 0 , 0 0 , 0 0 , 0 0 , 0 0 , 0 0 , 0 0 , 0 0 , 0 0 , 0 0 , 0 0 , 0 0 , 0 0 , 0 0 , 0 0 , 0 0 , 0 0 , 0 0 , 0 0 , 0 0 , 0 0 , 0 0 , 0 0 , 0 0 , 0 0 , 0 0 , 0 0 , 0 0 , 0 0 , 0 0 , 0 0 , 0 0 ;
0 0 , 0 0 , 0 0 , 0 0 , 0 0 , 0 0 , 0 0 , 0 0 , 0 0 , 0 0 , 0 0 , 0 0 , 0 0 , 0 0 , 0 0 , 0 0 , 0 0 , 0 0 , 0 0 , 0 0 , 0 0 , 0 0 , 0 0 , 0 0 , 0 0 , 0 0 , 0 0 , 0 0 , 0 0 , 0 0 , 0 0 , 0 0 , 0 0 , 0 0 , 0 0 , 0 0 , 0 0 , 0 0 , 0 0 , 0 0 , 0 0 , 0 0 , 0 0 , 0 0 , 0 0 , 0 0 , 0 0 , 0 0 , 0 0 , 0 0 ;
0 0 , 0 0 , 0 0 , 0 0 , 0 0 , 0 0 , 0 0 , 0 0 , 0 0 , 0 0 , 0 0 , 0 0 , 0 0 , 0 0 , 0 0 , 0 0 , 0 0 , 0 0 , 0 0 , 0 0 , 0 0 , 0 0 , 0 0 , 0 0 , 0 0 , 0 0 , 0 0 , 0 0 , 0 0 , 0 0 , 0 0 , 0 0 , 0 0 , 0 0 , 0 0 , 0 0 , 0 0 , 0 0 , 0 0 , 0 0 , 0 0 , 0 0 , 0 0 , 0 0 , 0 0 , 0 0 , 0 0 , 0 0 , 0 0 , 0 0 ;
0 0 , 0 0 , 0 0 , 0 0 , 0 0 , 0 0 , 0 0 , 0 0 , 0 0 , 0 0 , 0 0 , 0 0 , 0 0 , 0 0 , 0 0 , 0 0 , 0 0 , 0 0 , 0 0 , 0 0 , 0 0 , 0 0 , 0 0 , 0 0 , 0 0 , 0 0 , 0 0 , 0 0 , 0 0 , 0 0 , 0 0 , 0 0 , 0 0 , 0 0 , 0 0 , 0 0 , 0 0 , 0 0 , 0 0 , 0 0 , 0 0 , 0 0 , 0 0 , 0 0 , 0 0 , 0 0 , 0 0 , 0 0 , 0 0 , 0 0 ;
0 0 , 0 0 , 0 0 , 0 0 , 0 0 , 0 0 , 0 0 , 0 0 , 0 0 , 0 0 , 0 0 , 0 0 , 0 0 , 0 0 , 0 0 , 0 0 , 0 0 , 0 0 , 0 0 , 0 0 , 0 0 , 0 0 , 0 0 , 0 0 , 0 0 , 0 0 , 0 0 , 0 0 , 0 0 , 0 0 , 0 0 , 0 0 , 0 0 , 0 0 , 0 0 , 0 0 , 0 0 , 0 0 , 0 0 , 0 0 , 0 0 , 0 0 , 0 0 , 0 0 , 0 0 , 0 0 , 0 0 , 0 0 , 0 0 , 0 0 ;
0 0 , 0 0 , 0 0 , 0 0 , 0 0 , 0 0 , 0 0 , 0 0 , 0 0 , 0 0 , 0 0 , 0 0 , 0 0 , 0 0 , 0 0 , 0 0 , 0 0 , 0 0 , 0 0 , 0 0 , 0 0 , 0 0 , 0 0 , 0 0 , 0 0 , 0 0 , 0 0 , 0 0 , 0 0 , 0 0 , 0 0 , 0 0 , 0 0 , 0 0 , 0 0 , 0 0 , 0 0 , 0 0 , 0 0 , 0 0 , 0 0 , 0 0 , 0 0 , 0 0 , 0 0 , 0 0 , 0 0 , 0 0 , 0 0 , 0 0 ;
0 0 , 0 0 , 0 0 , 0 0 , 0 0 , 0 0 , 0 0 , 0 0 , 0 0 , 0 0 , 0 0 , 0 0 , 0 0 , 0 0 , 0 0 , 0 0 , 0 0 , 0 0 , 0 0 , 0 0 , 0 0 , 0 0 , 0 0 , 0 0 , 0 0 , 0 0 , 0 0 , 0 0 , 0 0 , 0 0 , 0 0 , 0 0 , 0 0 , 0 0 , 0 0 , 0 0 , 0 0 , 0 0 , 0 0 , 0 0 , 0 0 , 0 0 , 0 0 , 0 0 , 0 0 , 0 0 , 0 0 , 0 0 , 0 0 , 0 0 ;
0 0 , 0 0 , 0 0 , 0 0 , 0 0 , 0 0 , 0 0 , 0 0 , 0 0 , 0 0 , 0 0 , 0 0 , 0 0 , 0 0 , 0 0 , 0 0 , 0 0 , 0 0 , 0 0 , 0 0 , 0 0 , 0 0 , 0 0 , 0 0 , 0 0 , 0 0 , 0 0 , 0 0 , 0 0 , 0 0 , 0 0 , 0 0 , 0 0 , 0 0 , 0 0 , 0 0 , 0 0 , 0 0 , 0 0 , 0 0 , 0 0 , 0 0 , 0 0 , 0 0 , 0 0 , 0 0 , 0 0 , 0 0 , 0 0 , 0 0 ;
0 0 , 0 0 , 0 0 , 0 0 , 0 0 , 0 0 , 0 0 , 0 0 , 0 0 , 0 0 , 0 0 , 0 0 , 0 0 , 0 0 , 0 0 , 0 0 , 0 0 , 0 0 , 0 0 , 0 0 , 0 0 , 0 0 , 0 0 , 0 0 , 0 0 , 0 0 , 0 0 , 0 0 , 0 0 , 0 0 , 0 0 , 0 0 , 0 0 , 0 0 , 0 0 , 0 0 , 0 0 , 0 0 , 0 0 , 0 0 , 0 0 , 0 0 , 0 0 , 0 0 , 0 0 , 0 0 , 0 0 , 0 0 , 0 0 , 0 0 ;
0 0 , 0 0 , 0 0 , 0 0 , 0 0 , 0 0 , 0 0 , 0 0 , 0 0 , 0 0 , 0 0 , 0 0 , 0 0 , 0 0 , 0 0 , 0 0 , 0 0 , 0 0 , 0 0 , 0 0 , 0 0 , 0 0 , 0 0 , 0 0 , 0 0 , 0 0 , 0 0 , 0 0 , 0 0 , 0 0 , 0 0 , 0 0 , 0 0 , 0 0 , 0 0 , 0 0 , 0 0 , 0 0 , 0 0 , 0 0 , 0 0 , 0 0 , 0 0 , 0 0 , 0 0 , 0 0 , 0 0 , 0 0 , 0 0 , 0 0 ;
0 0 , 0 0 , 0 0 , 0 0 , 0 0 , 0 0 , 0 0 , 0 0 , 0 0 , 0 0 , 0 0 , 0 0 , 0 0 , 0 0 , 0 0 , 0 0 , 0 0 , 0 0 , 0 0 , 0 0 , 0 0 , 0 0 , 0 0 , 0 0 , 0 0 , 0 0 , 0 0 , 0 0 , 0 0 , 0 0 , 0 0 , 0 0 , 0 0 , 0 0 , 0 0 , 0 0 , 0 0 , 0 0 , 0 0 , 0 0 , 0 0 , 0 0 , 0 0 , 0 0 , 0 0 , 0 0 , 0 0 , 0 0 , 0 0 , 0 0 ;
0 0 , 0 0 , 0 0 , 0 0 , 0 0 , 0 0 , 0 0 , 0 0 , 0 0 , 0 0 , 0 0 , 0 0 , 0 0 , 0 0 , 0 0 , 0 0 , 0 0 , 0 0 , 0 0 , 0 0 , 0 0 , 0 0 , 0 0 , 0 0 , 0 0 , 0 0 , 0 0 , 0 0 , 0 0 , 0 0 , 0 0 , 0 0 , 0 0 , 0 0 , 0 0 , 0 0 , 0 0 , 0 0 , 0 0 , 0 0 , 0 0 , 0 0 , 0 0 , 0 0 , 0 0 , 0 0 , 0 0 , 0 0 , 0 0 , 0 0 ;
0 0 , 0 0 , 0 0 , 0 0 , 0 0 , 0 0 , 0 0 , 0 0 , 0 0 , 0 0 , 0 0 , 0 0 , 0 0 , 0 0 , 0 0 , 0 0 , 0 0 , 0 0 , 0 0 , 0 0 , 0 0 , 0 0 , 0 0 , 0 0 , 0 0 , 0 0 , 0 0 , 0 0 , 0 0 , 0 0 , 0 0 , 0 0 , 0 0 , 0 0 , 0 0 , 0 0 , 0 0 , 0 0 , 0 0 , 0 0 , 0 0 , 0 0 , 0 0 , 0 0 , 0 0 , 0 0 , 0 0 , 0 0 , 0 0 , 0 0 ;
0 0 , 0 0 , 0 0 , 0 0 , 0 0 , 0 0 , 0 0 , 0 0 , 0 0 , 0 0 , 0 0 , 0 0 , 0 0 , 0 0 , 0 0 , 0 0 , 0 0 , 0 0 , 0 0 , 0 0 , 0 0 , 0 0 , 0 0 , 0 0 , 0 0 , 0 0 , 0 0 , 0 0 , 0 0 , 0 0 , 0 0 , 0 0 , 0 0 , 0 0 , 0 0 , 0 0 , 0 0 , 0 0 , 0 0 , 0 0 , 0 0 , 0 0 , 0 0 , 0 0 , 0 0 , 0 0 , 0 0 , 0 0 , 0 0 , 0 0 ;
0 0 , 0 0 , 0 0 , 0 0 , 0 0 , 0 0 , 0 0 , 0 0 , 0 0 , 0 0 , 0 0 , 0 0 , 0 0 , 0 0 , 0 0 , 0 0 , 0 0 , 0 0 , 0 0 , 0 0 , 0 0 , 0 0 , 0 0 , 0 0 , 0 0 , 0 0 , 0 0 , 0 0 , 0 0 , 0 0 , 0 0 , 0 0 , 0 0 , 0 0 , 0 0 , 0 0 , 0 0 , 0 0 , 0 0 , 0 0 , 0 0 , 0 0 , 0 0 , 0 0 , 0 0 , 0 0 , 0 0 , 0 0 , 0 0 , 0 0 ;
